.A
able  =  в состоянии 
abuse  =  оскорбление
accase  =  обвинять
accelerate  =  ускорять
accent  =  подчеркивать ( выделять главное)
accomondation  =  жилье
ace  =  выдающийся
ache  =  боль
admit  =  признавать
adore  =  нравиться
advance  =  продвигать
advantage  =  преищество
adverb  =  наречие
advertise  =  рекламировать
advertisment  =   реклама
affair  =  дело 
affect  =  влиять
affirm  =  утверждать
afford  =  позволять купить
aid  =  помощь
aisle   =  проход
alive with smth  =  переполнен чем-то
although  =  хотя
among  =  среди
amuse  =  забавлять
anger  =  гнев
annoy  =  раздражать
anxious  =  тревожный
apeal  =  обращаться к кому-то
apologise  =  извиняться
apparently  =  видимо
appart  =  отдельно
appointment  =  назначение
appraise = appreciate
appreciate  =  ценить
approach  =  подходить
approax  =  приблизительно
approprate  =  определяющий
approve  =  утверждать
apron  =  фартук 
arcade  =  галерея
argue  =  спорить 
arrange  =  договориться
ascend  =  подниматься
ashes  =  пепел
assume  =  считать
astray  =  заблудиться
at once  =  сразу 
atrium  =  hall
attach  =  присоединять
attainable  =  достижимый
attend  =  посещать
attendant  =  служитель
avoid  =  избегать
aware  =  знающий 
awful  =  ужасный
awkward  =  неуклюжий
.B
bagel  =  бублик
bang  =  взрыв, удариться
barely  =  едва
bargain  =  сделка
barn  =  сарай, амбар
bash  =  ударять
be gang up on smb  =  ополчиться на 
be on table  =  обсуждать
be rambuctious with smb  =  шалить 
be trought  =  закончить
be turned on by smth  =  прийти в возбуждение от чего-то
beacon  =  маяк
bead  =  шарик
beam  =  светиться
bean  =  боб
beanstalk  =  бобовый стебель
bearing  =  опора
beehive  =  улей
beep  =  сигнал
beg  =  просить \\ request, ask
belch  =  отрыгать
belief  =  вера
belly  =  живот
benefin  =  приносить пользу 
bet  =  делать ставки
bethel  =  там, где молятся сектанты 
beware  =  остерегаться
bewitch  =  очарововать
beyond  =  вне
big time  =  еще какой!
billboard  =  рекламный щит
bing  =  резкий звук
blackout  =  аварийное отключение энергии
blast  =  взрывать
bliss  =  счастье
blobbies  =  капельки, крошки
blooby  =  размытый
blossom  =  цвести
blow off  =  тратить 
blur  =  пятно
boast  =  хвастаться \\ brag
bobsled  =  сани
boil  =  кипеть
bold  =  смелый \\ brave
bond  =  граница, соединять
bone  =  кость
boobs  =  сиськи
border on smth  =  быть похожим на что-то
bother  =  беспокоить
bound  =  граница, соединять
bout  =  встреча, схватка
bowl  =  катить, чаша
bra  =  ливчик
brag  =  хвастаться \\ boast
breast  =  грудь
breed   =  размножаться, порода
bride  =  невеста
bridemain  =  подруга невесты
brief  =  краткий        
bring smb down  =  расстроить
bring up  =  start a dialog with smb
broadcast  =   вещать
brood  =  размышлять
broom  =  метла 
brush  =  щетка
brutal  =  жестокий
bud  =  друг
bullet  =  пуля
bump  =  живот у беременной
bunch  =  связка
burgundy  =  винный цвет
burry   =  хоронить
burst = blast
bush  =  куст
bushy  =  пушистый
bust ass  =  разрываться
butt  =  задница
buzz in  =  впустить (дверь)
.C
cachet  =   печать
cancer  =  рак
candlelight   =  искусственный свет
carcass  =  туша
carve  =  резать
casket  =  гроб
casually  =  вскользь
catch on  =  понимать
catch up  =  догнать
cell   =  клетка, ячейка
cellar  =  подвал
certainly  =  конечно 
cervix  =  матка
chalk  =  мел
challenge  =  бросать вызов
chaotic  =  хаотический
chariot  =  колесница 
charity  =  благотворительность
chart  =  диаграмма
chase  =  погоня 
cheap shot  =  удар в больное место
check out  =  проверить 
cherish  =  нежно любить
chest  =  грудь
chew  =  жевать
chilly  =  холодный \\ cold
chip in  =  принимать участие 
choke  =  душить
chop  =  рубить
chorus  =  хор, припев
chubby  =  круглолицый
chute  =  парашют
circuit  =  схема
clad  =  одевать
claim  = требование
clause  =  пункт
claw  =  коготь
clench  =  сжимать
clover  =  клевер
club  =  дубина, бить
coal  =  уголь
coaster  =  подставка
coil  =  катушка
collapse  =  рухнуть
come around  =  приблизиться
come by  =  проходить мимо
come on  =  давай, появляться
compare  =  сравнивать
competitor  =  конкурент
complain  =  жаловаться
compound  =  соединять
conceal  =  скрывать
conceive  =  зачать
concern  =  относиться, касаться
conclate  =  завершать
conduct  =  проводить
confectinery  =  кондитерские изделия
confusion  =  путаница
conscious = сознательный
consecuence  =  последствие
consider  =  рассматривать
constable  =  полицейский
consume  =  подреблять
consummate  =  завершать
content  =  довольный 
contest  =  соревнование
contort  =  искажать
convenience   =  удобство
conventional  =  обычный 
convertible  =  откидной ( про крышу авто)
convince  =  убеждать
corncob  =  стержень кукурузы
cotton  =  хлопок
counter  =  прилавок 
courage  =  смелость
court  =  суд
cover  =  охватывать
coyote  =  койот
crack  =  трескаться
cramp  =  судорога
cranberry  =  клюква
crap  =  гадить
crappy  = плохой
crave = strong want
crawl  =  ползать
crease  =  складка, ворота, мять
creep  =  ползать
crew   =  экипаж
crispy  =  хрустящий
crook  =  аферист
crouch  =  пресмыкаться
cruse  =  совершать рейс
crush  =  раздавить
crust  =  кора 
cupid  =  купидон
curb  =  обочина
curry  =  карри
curse  =  проклинать 
cushion  =  смягчать
cute  =  милый
.D
dairy  =  молочный
damn  =  проклинать
damp  =  влажный
dare  =  посметь
deaf  =  глухой 
debate  =  обсуждать
debt  =  долг
decade  =  10 years
decaf  =  кофе без сахара
defiant  =  дерзкий
defy  =  игнорировать
delay  =  задержка
delicates  =  белье для нежной стирки
delight  =  восторг
delivery  =  доставка
denim = jeans
dent  =  вминать
deny  =  отрицать
derive  =  получать
descend  =  спускаться
desire  =  желание
desperation  =  отчаяние
detergent   =  моющее средство 
devastate  =  опустошать
devote  =  посвящать
dew  =  роса 
diaper  =  подгузник
dig   =  нравиться
dimenstion  =  измерение
dinah  =  круто
dip  =  мокать
dirt  =  грязь
disease  =  болезнь
disgrace  =  позор
disguise  =  максироваться
disgust  =  отвращение
ditch   =  канава
divorse  =  развеститсь
dizzy  =  дурманить
doggone  =  проклятый
doom  =  гибель
doubt  =  сомнение
dough  =  деньги
doy  =  понятное дело
doze  =  дремать
drag   =  бремя, тащить
drastic  =  решительный
dread  =  пугать
dress up  =  наряжаться
drift  =  самотек
drift apart with smb = 
drip  =  капать 
drown  =  тонуть
dug  =  выкопанный
dull  =  простой, тупой
dumb  =  тупой
dust  =  пыль
sidtort  =  искажать
.E
eager  =  нетерпеливый 
earring  =  серьга
effort  =  усилие
egagement  =  помолвка
elation  =  восторг
elbow  =  локоть
eligiable  =  подходящий
elusive  =  неуловимый
embarrassed  =  смущенный 
emphasise  =  подчеркивать
encourage  =  поощрять
endearing  =  красивый
endorse  =  одобрять
engorge = поглощать
enquire  =  спрашивать
enrage  =  бесить
enrolment  =   регистрация
entertainment  =  развлечение
entire  =  весь
entitle  =  давать право, озаглавливать
environment  =  среда 
envy  =  завидовать
erect  =  прямой, возводить
essential  =  существенный 
estabilish  =  устанавливать
eternity  =  вечность
etrepreneur  =  преприниматель
eventually  =  в конце концов
evolve  =  развиваться
exactly  =  точно
exception  =  исключение
excitation  =  возбуждение
excite  =  возбуждать
exclanation  =  восклицание 
executive  =  исполнительный
expire  =  истекать
explode  =  взрываться
expose  =  выставлять 
extend  =  продливать
extinct  =  вымерший
extinction =  вымирание
extract  =  извлекать
eyelash  =  ресница
.F
facilities  =  средства
fade  =  увядать
fag  =  сигарета
fall behind  =  оставать 
familar  =  знакомый
famished = hungry
fancy  =  модный, фантазия, предполагать
fancy = free = single(not in love)
fare = tax for traveling
fate  =  судьба
favor  =  польза 
feast  =  праздник
feather  =  перо
feature  =  особенность
feces  =  shit
fella  =  парень
fetus  =  плод
figure it  =  понять это
fingernail  =  ноготь
fits  =  припадки
flash  =  вспышка
flattered  =  смущенный
flaw  =  недостаток
flea  =  блоха
flesh  =  плоть
float  =  плавать
floppy  =  висящий, дискета
flow  =  течь
fluff  =  взбибать, пух
flupie  =  расстерянный
flush  =  промывать, румянец
flut  = флейта
foam  =  пена 
folk  =  народ
forecast  =  прогноз
foresee  =  предвидеть
forgive  =  прощать
forth  =  вперед 
forward  =  вперед
fraction  =  доля
freak   =  урод
freak out  =  возбуждать
fright  =  пугать
frustate  =  срывать
funeral  =  похороны
funky  =  испуганный
fuse  =  предохранитель
futile  =  бесполезный
fuzzy  =  пушистый 
.G
gag  =  затыкать рот, хамить
gain  =  давать
gal  =  девченка 
gallon  =  множество
gap  =  разрыв
gather  =  собираться вместе
gay  =  веселый
gaze  =  смотреть
gee   =  вот здорово!
geeky  =  придурковатый
gesture  =    жест
get around  =  приближаться
get by  =  обойтись
get in  =  входить
get up  =  вставать 
giant  =  гиганстский
gills  =  жабры
gimmicky  =  бесполезный
give smb a lift  =  позвезти на авто
glacier  =  ледник
gleam  =  светиться
glimpse  =  мелькать
glitter  =  блеск
glow  =  светиться
goggles  =  темные очки
goose  =  гусь, освистывать
gorgeous  =  величественный
gosh!  =  damn! 
gossip  =  сплетни
gotta  =  должен
grab  =  захватить
grace  =  благодать
grave  =  могила
gravy  =  соус
grieve  =  горевать 
grip  =  захват
grits  =  овсянка
grocery  =  продуктовый
groin = пах
groove  =  радовать
groove on  =  отрываться по полной
gross  =  гадость
groundwork  =  фундамент
guard  =  охранять
guide  =  направлять
guilty  =  виновен
guts  =  кишки
.H
handful  =  горсть
handle  =  обращаться
handsome   =  красивый
hang around  =  бродить вокруг
hanger  =  вешалка
haphazard  =  случайный 
harm  =  вредить
harp  =  арфа
haul  =  везти, буксировать
have a thing for smb  =  любить кого-то, хранить для кого-то
have a thing with smb  =  встречаться с кем-то
heel  =  каблук
herd  =  стадо
hide  =  прятать
hip  =  модный, бедро
hitch  =  подтягивать
hither  =  ближний, сюда
hoax  =  обман
hoist  =  поднимать
holler  =  кричать \\ shut
hop  =  прыгать  
horrify  =  ужасать
however  =  однако
howl  =  вой
huckle  =  бедро
huckleberry  =  черника
huddle  =  прижиматься
hug  =  обнимать
hump  =  горбиться
hurry  =  торопиться
hush  =  тишина, успокаивать 
huzy  =  туманный
.I
immediately  =  немедленно
imp  =  чертенок
impatience  =  нетерпение
impish  =  шаловливый
impose  =  навязывать
in terms  =  с точки зрения
inch  =  медленно двигаться
indeed  =  действительно
index finger  =  указательный палец
inherite  =  унаследовать 
injure  =  травмировать
innate  =  врожденный
inquire  =  спрашивать
insane  =  безумный
inscription  =  надпись
insomnia  =  бессоница
inspire  =  вдохновлять
instance  =  пример
instantly  =  немедленно
intent  =  намереваться
intestine  =  кишки
involve  =  включать
irritate  =  раздражать
issue  =  вопрос, выдавать
.J
jake  =  гнездо
jammies  =  пижама
jar  =  банка
jaw  =  челюсть
jerk  =  негодяй 
jeweler  =  ювелир
jive  =  болтовня, ложный
jock = жокей
joint  =  соединять
juggle  =  жонглировать 
junk  =  хлам
.K
keep up  =  поддерживать, догонять
kettle  =  чайник
kid  =  обманывать
kit  =  комплект 
knuckle  =  кулак
knuckle cracking  =  хруст пальцев
kook  =  чокнутый
.L
labor  =  труд
lad  =  парень
lamb  =  ягненок
lass  =  девушка
laundry  =  прачечная
lean  =  прислоняться
leather  =  кожа
leave  =  отпуск, уход
let smb down  =  подводить 
link  =  соединять
literacy  =  грамотность
loathe  =  hate
look forward to  =  ждать с нетерпением
look out  =  высматривать
look up  =  искать 
loop  =  петля
looter  =  мародер
loss  =  потеря
lounge  =  гостинная  
lousy  =  плохой
luminous  =  светящийся
lump  =  кусок
lunar  =  лунный
luxury  =  роскошь
.M
madcap  =  безрассудный 
maid  =  дева, горничная
maid of honor  =  подруга невесты
mainsail  =  грот
make out  =  осознать
malt  =  солод
maneuver  =  маневр
mangle  =  калечить 
march  =  марш
mash  =  пюре
mat  =  коврик
match  =  соответствовать
mate  =  помощник
matter  =  дело, вопрос
mean  =  подлый
measure = 
melt  =  таять 
mend  =  чинить
mental  =   мысленный 
mention  =  упоминать
mess  =  беспорядок
might  =  мощь
mingle  =  общаться 
minion  =  фаворит
mint  =  чеканить
mislead  =  вводить в заблуждение
mistress = lover (female)
misty  =  туманный
mitten  =  варежка
mock  =  goose 
moisturizer  =  увлажнитель
moose  =  лось
motion  =  движение 
mud  =  грязь
mull  =  размышлять
multiply  =  мнократно
mummal  =  млекопитающее
murky грязный  = 
murshmallow  =  зефир
mystique  =  мистика
.N
nail  =  гвоздь
nake   =  голый 
nape  =  затылок
nate  =  пашнет
native  =  родной
nausea  =  тошнить
neat  =  аккуратный
neck  =  шея
needle  =  иголка 
negotiate  =  вести переговоры
nibble  =  грызть
nipple = сосок
noble   =  благородный, дворянский
nocturnal  =  ночной
nod off  =  спать
noodles  =  лапша
notice  =  замечать
notion  =  сведение
nova  =  новинка
numb  =  поражать, онемелый
.O
obligate  =  обязывать
obtain  =  получать
obviously  =  очевидно
odd  =  странный , нечетный
odds  = шансы
officiate  =   исполнять обязанности
omelet  =  омлет
omnipotent  =  всемогущий
onion  =  лук
otherwise  =  с другой стороны, иначе
ottoman  =  диван 
oughta  =  должен
oven  =  печь
overcoat  =  пальто
owe  =  задолжать
.P
pace  =  скорость, темп
pad  =  подушка, мешок, делать записи
pal  =  приятель 
pan  =  кстрюля
pancake  =  блин (еда)
particular  =  особый
pass  =  проходить мимо, передавать
passion  =  страсть
path  =  пластырь
pathetic  =  жалкий
peach  =  персик
peach pit  =  косточка от персика 
peacock  =  павлин
peanut  =  арахис
pearl  =  жемчуг
peas  =  горох
pee  =  писать
peel  =  кожура, чистить
peer  =  вглядываться
perceive  =  воспринимать
percentage  =  процент
perform  =  выполнять 
perfume  =  духи
perhabs  =  возможно
perk  =  привелегия, cafe
permanent  =  постоянный
permit  =  разрешать
perpetual  =  вечный
persuade  =  убеждать
pick off  =  обрывать
pick out  =  выбирать
pick up  =  подбирать, забирать
piece  =  кусок
pier  =  пирс
pierce  =  прокалывать
pigeon  =  голубь
pill  =  таблетка
pillow  =  подушка
pipe   =  трубка
plate  =  плита 
plug  =  вставлять
plunge = dive
plural  =  множественное число
pool table  =   билиардный стол
porcelain  =  фарфор
pour  =   лить
powder  =   порошок
pray  =  молиться
predicament  =  затруднительный 
prediction  =  прогноз
premise  =  предпосылка
preposition  =  предлог
preppy  =  среднеклассник
presumable = 
pretend  =  притворяться
pretzel  =  крендель
prevent  =  предотвращать
pride  =  гордость
priest  =  священник
probe  =  исследовать
projectile  =  летящий предмет
pronoun  =  местоимение
proper  =  надлежащий
proposal  =  предложение
pros  =  профи
proud  =  гордый
provide  =  обеспечивать
puck  =  шайба
puff    =  пыхтеть
punch  =  бить
purchase  =  покупать
pure  =  чистый
purpose  =  цель, намереваться
purse  =  кошелек
put up  =  смириться
.Q
.R
race  =  расса 
rage  =  буянить, ярость
ragged   =  рваный
raise  =  поднимать, вырастить
rap  =  стучать
rapport  =  взаимопонимание
rapture   =  восторг
rave  =  бредить, вечеринка
reach  =  достигать 
read out  =  читать вслух
read up on  =  найти в тексте
realise   =  осознавать
reap  =  пожинать
reason   =  разум
reassure  =  успокаивать
reckness  =  безрассудный  
reckon  =  думать
recorgnise  =  признавать
rect  =  прямоугольник
reduction  =  сокращение 
refer  =  ссылаться
reference  =  справляться, упоминание
regret  =  сожалеть
rein  =  повод, сдерживать
reindeer северный олень = 
reject  =  отклонять
relief  =  облегчение
relieve  =  освобождать
remain  =  оставаться
reqiest  =  просьба
require  =  требовать
resentment  =  негодование
resque  =  спасать
ressurect  =  воскрешать
rest  =  остальные
restring = перетянуть струну
retainer  =  скобы на зубы
rethink  =  передумать 
retina  =  сетчатка
reveal  =  раскрывать
revealation  =  откровение
revise  =  повторять изученный материал
rid  =  избавляться
ridiculous  =  смешно
right out  =  сразу после
rip  =  разрывать
rite  =  обряд
rival  =  соперник
roam  =  скитаться
roar  =  реветь
robe =  халат
roll  =  катить
roll with punches = 
romance  =  романтика
rotten  =  плохой
rough  =  грубо
route  =  маршрут
rover  =  странник
row  =  грести
rub  =  теперь
rumor  =  слух(сплетня)
run over  =  перехать что-то кого-то
rural  =  сельская местность
.S
sacred  =  священный
sag  =  свисать
sanctuary  =  святилище
satetellite  =  искусственный спутник
savior  =  спаситель
scary  =  пугать
scatter  =  рассеиваться
schedule  =  график
scramble  =  схватка
scratch  =  царапать 
screw  =  обманывать
scum  =  пена / сволочь
seek  =  искать
senile  =  старческий
sensation  =  ощущение
sequence  =  последовательность
serunchie  =  злой 
settle  =  estabilish, set, урегулировать
severe  =  тяжелый
sew = шить
shave = брить
shell  =  раковина,  внешний вид
sheme  =  схема
sheming  =  коварный
shimmer  =  мерцать
shiver  =  трястись  
shoe  =  обувь
shoot for the stars = 
shore  =  берег
shot  =  выстрел 
show off  =  выпендриваться
shred  =  резать
sidewalk  =  тротуар
sigh  =  вдыхать
sign  =  знак
significant  =  значимый
silly  =  глупый
sip  =  медленно попивать
skip  =  пропускать, прыгать
skull  =  череп
slam  =  хлопать
slap  =  пощечина
sled  = сани
sleeve  =  рукав 
sleigh  =  сани
slide  =  скользить
slip  =  скользить
slugger = здоровяк
slumber  =  спать
slumber party  =  пижамная вечеринка
smart   =  умный, изящный
smash  =  разбивать
smidge  =  очень мало 
smirk  =  ухмылка
snap  =  защелкивать
sneeze  =  чихать
sniff  =  нюхать
snort  =  фыркать
soak  =  впитывать
soar  =  летать
sob  =  рыдать
sophisticated  =  сложный
sour  =  кислый 
spark  =  искра
spatula  =  кулинарная лопатка
spell  =  означать
spell out  =  расшифровать
spill  =  проливать
spin  =  крутить
spine  =  позвоночник
spit  =  плевать
splash  =  всплескивать 
split  =  раскалывать
spooky  =  жуткий
spot  =  место, определить
spout  =  струиться
spread  =  распространять 
sprinkle   =  посыпать
spritz  =  брызгаться
spur  =  побуждать
squeeze  =  выжимать
squirell  =  белка
squirm  =  извиваться
stack  =  груда
staff  =  персонал
stair  =  ступень
stake  =  делать ставки
stalk  =  подкрадываться
stand by  =  поддерживать
stare  =  пялиться
starve  =  голодать
stately  =  величественный
steady  =  устойчивый
steer  =  управлять
step back  =  отступить
stick  =  держатьсяs
still  =  спокойствие
stock  =  запас
stomp  =  топать
strange  =  чужой
strap = thong
stretch  =  расправлять
strew  =  посыпать
strict  =  строгий
strip  =  полоса
struck  =  пораженный
struggle  =  борьба
stuck  =  застрять
stuff  =  вещи
stuffing  =  начинка 
stun  =  огушать 
subtle  =  тонкий
suburban  =  пригородный
sudden  =  неожиданный 
suds  =  мыльная пена 
suffer  =  страдать
superficial  =  поверхностый
supply  =  снабжать
suppose  =  предполагать
supremely  =  в высшей степени
surrond  =  окружать
survey  =  обзор
survive  =  выживать
swallow  =  глотать, ласточка
swarm  =  толпиться
swear  =  поклясться 
sweep  =  подметать 
swing  =  качели 
syllable  =  слог
.T
tackle  =  fight
take time  =   выжидать
take up   =  занимать
tambourine  =  бубен
tan  =  загорать
tease  =  дразнить
teaser  =  задира
tell  =  отличать
temper  =  характер
tender  =  нежный, предлагать
terrific  =  красивый
therefore  =  поэтому
thigh  =  бедро
thong  =  ремень
thorn  =  беспокоить 
thrill  =  трепетать
thrive  =  процветать
throb = feel scary
throw  =  бросать
thumb  =  большой палец
thump  =  стучать
thunder  =  гром
tidal  =  приливной 
tidy  =  опрятный 
tie  =  связывать
tight  =  плотно, крепко
tile  =  черепица, плитка 
tilt  =  наклонять
tinfoil  =  фольга
tinkle  =  звонить 
tip =  накглонять, конец, чаевые
toad  =  жаба
toboggan   =  сани 
toe  =  носок, палец 
tongue  =  язык
tonsil = гланда
tough  =  жестокий
towel  =  полотенце
trace   =  следить
track  =  путь, след
traffic  =  движение 
trick  =  трюк, хитрость
troll  =  катиться
tromple  =  топтать
trunk  =  ствол, багажник
tub  =  ванна
tummy  =  животик 
turkey  =  индейка
tweezers  =  пинцет 
twirly  =  кружащийся 
.U
uberweiss  =  отбеливатель (нем)
underpants  =  трусы
underwear  =  нижнее белье
upside  =  вверх
urinate  =  pee
.V
vacation  =  отпуск
vague  =  смутный
valuable  =  ценный
variety  =  разнообразие
vary  =  меняться
vast  =   огшромный
vengeance  =  месть
verge  =  грань
via  =  через
vibe  =  дух, аура
vividly  =  живо
vom  =  рвота
vow  =  клятва, обет
vowel  =  классная буква 
vulner  =  уязвимый
.W
waddle  =  еле ходить
wage  =  зарплата
waist  =  талия
wallet  =  кошелек
warden  =  босс
warn   =  предупреждать
wave  =  волна 
wax  =  прибывать
way up  =  вплоть 
weariness  =  усталость 
weasel  =  ласка (зверь) 
wee  =  маленький
weep  =  плакать 
weirdo  =  чудак
well  =  колодец
well up  =  комок в горле 
whipped  =  взбитый
whisker  =  усы
whiz   =  whistle 
widow  =  вдова 
will  =  хотеть , желание
willing  =  готовый
wipe  =  протирать
wire  =  телефонный провод 
wise  =  широкий
within  =  внутри
witty  =  остроумный
wonder  =  удивляться
wondrous  =  красивый
woozy = person feels dizzy
word of mouth  =  устно
work out  =  отрабатывать 
worth  =  стоимость
wound  =  рана
wrap  =  оборачивать
wrist   =  запястье
write out   =  выписать
write up  =  подробно описать
.X
.Y
yam  =  сладкий картофель
yardstick  =  критерий
yell  =   кричать
.Z
